o=2, d=5, b=2, t=1

xxxxxxxxxxxxxxxxxxxx
y                  y
y p                y
y  y     zzzzz     y
y  y         y     y
y  y         y     y
y  y         y     y
y  y         y     y
y  y         y     y
y  y         y     y
y  y         y     y
y  y         xxx   y
y                  y
y      zzzzz       y
y        wwww      y
y  wwww   wwwww    y
y      wwwww       y
y                  y
y                  y
xxxxxxxxxxxxxxxxxxxx